Elnevezési konvenció:
---------------------
AccessText – at
Border – brd
BulletDecorator – bd
Button – btn
Calendar – cal
Canvas – cnv
CheckBox – chk
ComboBox – cbo
ContextMenu – ctx
DataGrid – dg
DatePicker – dat
DockPanel – dp
Expander – exp
Frame – fr
Grid – grd
GridSplitter – gsp
GroupBox – grp
Hyperlink – hyp
Image – img
InkCanvas – ikc
InkPresenter – ikp
Label – lbl
ListBox – lb
ListView – lv
MediaElement – me
Menu – mnu
NavigationWindow – nw
Page – pg
Panel – pnl
PasswordBox – pwd
Popup – pop
ProgressBar – pb
RadioButton – rdo
ResizeGrip – rgr
RepeatButton – rpt
RichTextBox – rtb
ScrollBar – sb
ScrollViewer – sv
Separator – sep
Slider – sli
StackPanel – sp
StatusBar – stb
TabControl – tab
TabItem – tbi
TextBlock – tb
TextBox – txt
Thumb – th
ToolBar – tbr
ToolTip – tt
TreeView – tv
Viewbox – vb
VirtualizingStackPanel – vsp
Window – win
WrapPanel – wp